0000000000000000000000000000000000000000
0000000000000000000000000000000000000000
0011111111111111111111111111111111111100
0011111111111111111111111111111111111100
0011001100000000000000000000000011001100
0011001100000000000000000000000011001100
0011001100000000000000000000000011001100
0011001100000000000000000000000011001100
0011001111111111111111111111111111001100
0011001111111111111111111111111111001100
0011000000000000000000000000000000001100
0011000000000000000000000000000000001100
0011111111111111111111111111111111111100
0011111111111111111111111111111111111100
0011000000000000001111000000000000001100
0011000000000000001111000000000000001100
0011111111111111000011001111111111111100
0011111111111111000011001111111111111100
0011000000000011001111001100000000001100
0011000000000011001111001100000000001100
1111111111111111001100001111111111111111
1111111111111111001100001111111111111111
0011000000000011001111001100000000001100
0011000000000011001111001100000000001100
0011000000000011111111111100000000001100
0011000000000011111111111100000000001100
0011000000000011000000001100000000001100
0011000000000011000000001100000000001100
0011000000000011111111111100000000001100
0011000000000011111111111100000000001100
0011000000000011000000001100000000001100
0011000000000011000000001100000000001100
0011000000000011000000001100000000001100
0011000000000011000000001100000000001100
0011000000000011000000001100000000001100
0011000000000011000000001100000000001100
0011111111111111111111111111111111111100
0011111111111111111111111111111111111100
0000000000000000000000000000000000000000
0000000000000000000000000000000000000000