00000000000000000000
01111111111111111110
01010000000000001010
01010000000000001010
01011111111111111010
01000000000000000010
01111111111111111110
01000000011000000010
01111111001011111110
01000001011010000010
11111111010011111111
01000001011010000010
01000001111110000010
01000001000010000010
01000001111110000010
01000001000010000010
01000001000010000010
01000001000010000010
01111111111111111110
00000000000000000000