==========================================================================================
==========================================================================================
====..................................................................................====
====..................................................................................====
====....====....==========================================================....====....====
====....====....==========================================================....====....====
====....====....==========================================================....====....====
====....====....==========================================================....====....====
====....====..................................................................====....====
====....====..................................................................====....====
====....==========================================================================....====
====....==========================================================================....====
====..................................................................................====
====..................................................................................====
====....=================================........=================================....====
====....=================================........=================================....====
====.................................========....====.................................====
====.................................========....====.................................====
====....=========================....====........====....=========================....====
====....=========================....====........====....=========================....====
.....................................====....========.....................................
.....................................====....========.....................................
====....=========================....====........====....=========================....====
====....=========================....====........====....=========================....====
====....=========================........................=========================....====
====....=========================........................=========================....====
====....=========================....================....=========================....====
====....=========================....================....=========================....====
====....=========================........................=========================....====
====....=========================........................=========================....====
====....=========================....================....=========================....====
====....=========================....================....=========================....====
====....=========================....================....=========================....====
====....=========================....================....=========================....====
====....=========================....================....=========================....====
====....=========================....================....=========================....====
====..................................................................................====
====..................................................................................====
==========================================================================================
==========================================================================================