000000000000000000000000000000000000000000000000000000000000000000000000000000000000000000
000000000000000000000000000000000000000000000000000000000000000000000000000000000000000000
000011111111111111111111111111111111111111111111111111111111111111111111111111111111110000
000011111111111111111111111111111111111111111111111111111111111111111111111111111111110000
000011110000111100000000000000000000000000000000000000000000000000000000001111000011110000
000011110000111100000000000000000000000000000000000000000000000000000000001111000011110000
000011110000111100000000000000000000000000000000000000000000000000000000001111000011110000
000011110000111100000000000000000000000000000000000000000000000000000000001111000011110000
000011110000111111111111111111111111111111111111111111111111111111111111111111000011110000
000011110000111111111111111111111111111111111111111111111111111111111111111111000011110000
000011110000000000000000000000000000000000000000000000000000000000000000000000000011110000
000011110000000000000000000000000000000000000000000000000000000000000000000000000011110000
000011111111111111111111111111111111111111111111111111111111111111111111111111111111110000
000011111111111111111111111111111111111111111111111111111111111111111111111111111111110000
000011110000000000000000000000000000000001111111100000000000000000000000000000000011110000
000011110000000000000000000000000000000001111111100000000000000000000000000000000011110000
000011111111111111111111111111111111100000000111100001111111111111111111111111111111110000
000011111111111111111111111111111111100000000111100001111111111111111111111111111111110000
000011110000000000000000000000000111100001111111100001111000000000000000000000000011110000
000011110000000000000000000000000111100001111111100001111000000000000000000000000011110000
111111111111111111111111111111111111100001111000000001111111111111111111111111111111111111
111111111111111111111111111111111111100001111000000001111111111111111111111111111111111111
000011110000000000000000000000000111100001111111100001111000000000000000000000000011110000
000011110000000000000000000000000111100001111111100001111000000000000000000000000011110000
000011110000000000000000000000000111111111111111111111111000000000000000000000000011110000
000011110000000000000000000000000111111111111111111111111000000000000000000000000011110000
000011110000000000000000000000000111100000000000000001111000000000000000000000000011110000
000011110000000000000000000000000111100000000000000001111000000000000000000000000011110000
000011110000000000000000000000000111111111111111111111111000000000000000000000000011110000
000011110000000000000000000000000111111111111111111111111000000000000000000000000011110000
000011110000000000000000000000000111100000000000000001111000000000000000000000000011110000
000011110000000000000000000000000111100000000000000001111000000000000000000000000011110000
000011110000000000000000000000000111100000000000000001111000000000000000000000000011110000
000011110000000000000000000000000111100000000000000001111000000000000000000000000011110000
000011110000000000000000000000000111100000000000000001111000000000000000000000000011110000
000011110000000000000000000000000111100000000000000001111000000000000000000000000011110000
000011111111111111111111111111111111111111111111111111111111111111111111111111111111110000
000011111111111111111111111111111111111111111111111111111111111111111111111111111111110000
000000000000000000000000000000000000000000000000000000000000000000000000000000000000000000
000000000000000000000000000000000000000000000000000000000000000000000000000000000000000000